stage_id,resource_type,resource_id,resource_number
101001,0,2,1
101002,0,2,5
101003,0,2,1
101004,0,2,1
101005,0,2,1
101006,0,2,1
101007,0,2,1
101008,0,2,1
101009,0,2,1
101010,0,2,1
102001,0,2,1
102002,0,2,1
102003,0,2,1
102004,0,2,1
102005,0,2,1
102006,0,2,1
102007,0,2,1
102008,0,2,1
102009,0,2,1
102010,0,2,1
103001,0,2,1
103002,0,2,1
103003,0,2,1
103004,0,2,1
103005,0,2,1
103006,0,2,1
103007,0,2,1
103008,0,2,1
103009,0,2,1
103010,0,2,1
